1 1 1 1 1 1 1 1 1 1 1 1 1 1 1 1 1 1 1 1
1 3 3 3 3 1 3 3 3 3 3 3 3 3 1 3 3 3 3 1
1 3 1 1 3 1 3 1 1 1 1 1 1 3 1 3 1 1 3 1
1 3 1 3 3 3 3 3 3 3 3 3 3 3 3 3 3 1 3 1
1 3 1 3 1 1 3 1 1 5 6 1 1 3 1 1 3 1 3 1
1 3 3 3 3 3 3 1 4 0 0 7 1 3 3 3 3 3 3 1
1 3 1 3 1 1 3 1 1 1 1 1 1 3 1 1 3 1 3 1
1 3 1 3 3 3 3 3 3 2 3 3 3 3 3 3 3 1 3 1
1 3 1 1 3 1 3 1 1 1 1 1 1 3 1 3 1 1 3 1
1 3 3 3 3 1 3 3 3 3 3 3 3 3 1 3 3 3 3 1
1 1 1 1 1 1 1 1 1 1 1 1 1 1 1 1 1 1 1 1
9 7 0 0
2 1 1 4
